00100
11111
11011
10001
11111
10001